##########
S        #
#######  #
#        #
## #### ##
#  # #   #
# ## #####
# #  #   #
#        #
########F#