#F#############
#    # #  #   #
#### # #  # # #
#    # #    # #
# #### #  # # #
#        ## # #
#########   # #
#         ### #
########### # #
S           # #
########### # #
#             #
####### #######
#             #
###############
