#S############################
# #                          #
#    ### # ######### ####### #
####   # # #       #     # # #
#    ### # # ##### # ##### # #    
# ## #   # # # # # #     # # #
#  # ### # #     # # ### # # #
# ## #   # ####### # # # # # # 
# ###### #         # # # # # #
# #      ############# # # # # 
# ######             # # # # #
#      # ########### # # # # #
######## #           # # # # #
#  #   # # ########### ### # #
## # # # # #         #     # #
#  # # # # # ###### #### ### #
## # # # #     #    #        #  
#  # # # ##### #### ##########
## # # # #     #    #        #  
#  # # # # # # #### # ###### #
## # # # # # # #    # # ## # #
#  # # # # # # #  # # #  # # #
## # # # # # # # ## # ##     #
#  # # # # # #    #    # #####    
## # # # # ###### #### #     #
#  # # #        #   ## # ### #
##   # # # ###### #  # # #   #
###### # # # # ## ## # # # ###
#        #        ## # # #   #
############################F#
